ni	ADV
ƕazuh	ADJ
saei	PRON
qiþiþ	VERB
mis	PRON
frauja	NOUN
frauja	NOUN
inngaleiþiþ	VERB
in	ADP
þiudangardja	NOUN
himine	NOUN
ak	CCONJ
sa	DET
taujands	VERB
wiljan	NOUN
attins	NOUN
meinis	ADJ
þis	DET
in	ADP
himinam	NOUN

akei	CCONJ
swe	ADV
raihtis	ADV
in	ADP
allamma	ADJ
managniþ	VERB
galaubeinai	NOUN
jah	CCONJ
waurda	NOUN
jah	CCONJ
kunþja	NOUN
jah	CCONJ
in	ADP
allai	DET
usdaudein	NOUN
jah	CCONJ
ana	ADV
þizai	DET
us	ADP
izwis	PRON
in	ADP
uns	PRON
frijaþwai	NOUN
ei	ADV
jah	ADV
in	ADP
þizai	DET
anstai	NOUN
managnaiþ	VERB
