ni	ADV
ƕazuh	ADJ
saei	PRON
qiþiþ	VERB
mis	PRON
frauja	NOUN
frauja	NOUN
inngaleiþiþ	VERB
in	ADP
þiudangardja	NOUN
himine	NOUN
ak	CCONJ
sa	DET
taujands	VERB
wiljan	NOUN
attins	NOUN
meinis	ADJ
þis	DET
in	ADP
himinam	NOUN

akei	CCONJ
swe	ADV
raihtis	ADV
in	ADP
allamma	ADJ
managniþ	VERB
galaubeinai	NOUN
jah	CCONJ
waurda	NOUN
jah	CCONJ
kunþja	NOUN
jah	CCONJ
in	ADP
allai	DET
usdaudein	NOUN
jah	CCONJ
ana	ADV
þizai	DET
us	ADP
izwis	PRON
in	ADP
uns	PRON
frijaþwai	NOUN
ei	ADV
jah	ADV
in	ADP
þizai	DET
anstai	NOUN
managnaiþ	VERB

andhof	VERB
imma	PRON
so	DET
managei	NOUN

ƕa	PRON
allis	ADV
ubilis	ADJ
gatawida	VERB

þu	PRON
is	AUX
þiudans	NOUN
Iudaie	NOUN

andhof	VERB
Iesus	PROPN
jah	CCONJ
qaþ	VERB

duƕe	ADV
miþ	ADP
þaim	DET
motarjam	NOUN
jah	CCONJ
frawaurhtaim	ADJ
matjid	VERB
jah	CCONJ
drigkid	VERB

bigitans	VERB
warþ	VERB
þaim	DET
mik	PRON
ni	ADV
gasokjandam	VERB

ak	CCONJ
gagg	VERB
jah	CCONJ
ataugei	VERB
þuk	PRON
silban	PRON
gudjin	NOUN
jah	CCONJ
atbair	VERB
imma	PRON
fram	ADP
þizai	DET
gahraineinai	NOUN
þeinai	ADJ
þatei	PRON
anabaud	VERB
Moses	PROPN
du	ADP
weitwodiþai	NOUN
im	PRON

In	ADP
jainaim	DET
þan	ADV
dagam	NOUN
aftra	ADV
at	ADP
filu	ADV
managai	ADJ
managein	NOUN
wisandein	AUX
jah	CCONJ
ni	ADV
habandam	VERB
ƕa	PRON
matidedeina	VERB
athaitands	VERB
siponjans	NOUN
qaþ	VERB
uh	CCONJ
du	ADP
im	PRON

manna	NOUN
sums	DET
galaiþ	VERB
af	ADP
Iairusalem	PROPN
in	ADP
Iaireikon	PROPN
jah	CCONJ
in	ADP
waidedjans	NOUN
frarann	VERB
þaiei	PRON
jah	CCONJ
biraubodedun	VERB
ina	PRON
jah	CCONJ
banjos	NOUN
analagjandans	VERB

ni	ADV
teikais	VERB
nih	CCONJ
atsnarpjais	VERB
nih	CCONJ
kausjais	VERB

in	ADP
þammei	PRON
alla	DET
gatimrjo	NOUN
gagatiloda	VERB
wahseiþ	VERB
du	ADP
alh	NOUN
weihai	ADJ
in	ADP
fraujin	NOUN

þanuh	ADV
was	AUX
maurgins	NOUN

ni	ADV
bairaiþ	VERB
pugg	NOUN
nih	CCONJ
matibalg	NOUN
nih	CCONJ
gaskohi	NOUN

ni	ADV
mag	VERB
bagms	NOUN
þiuþeigs	ADJ
akrana	NOUN
ubila	ADJ
gataujan	VERB
nih	CCONJ
bagms	NOUN
ubils	ADJ
akrana	NOUN
þiuþeiga	ADJ
gataujan	VERB

fauhons	NOUN
grobos	NOUN
aigun	VERB
jah	CCONJ
fuglos	NOUN
