Heit	AUX
der	PRON
scho	ADV
gschaffet	VERB
oder	CCONJ
göt	VERB
der	PRON
ersch	ADV
go	PART
schaffe	VERB
?	PUNCT

Und	CCONJ
i	ADP
dem	DET
Moment	NOUN
hani	AUX
natürlech	ADV
huerä	ADJ
Schiss	NOUN
gha	AUX
und	CCONJ
nöd	PART
gwüsst	VERB
wa	PRON
sägä	VERB
òder	CCONJ
machä	VERB
.	PUNCT

Si	PRON
isch	AUX
euses	DET
Kulturerb	NOUN
und	CCONJ
isch	AUX
starch	ADJ
mit	ADP
eusem	DET
Läbe	NOUN
und	CCONJ
eusere	DET
Gschicht	NOUN
verbunde	VERB
.	PUNCT

Es	PRON
söu	AUX
doch	ADV
bitte	ADV
