input	output	language
Migosi Odundo ne okone nyakalondo mar Ramogi ni achijno bende ne omaki gi misip ma ityiogodo e idhoo yien mar stima , kachiel gi apiko mane otiyo godo kowuok dalagi egweng mag Got Nanga kod Weyni mane osengado	Migosi_O Odundo_O ne_O okone_O nyakalondo_O mar_O Ramogi_B-PER ni_O achijno_O bende_O ne_O omaki_O gi_O misip_O ma_O ityiogodo_O e_O idhoo_O yien_O mar_O stima_O ,_O kachiel_O gi_O apiko_O mane_O otiyo_O godo_O kowuok_O dalagi_O egweng_O mag_O Got_O Nanga_O kod_O Weyni_O mane_O osengado_O	luo
E ote mane oor ne ute fwambo , bad migao mar thieth olero ni jii 169 owe thuolo odok pacho bang chango .	E_O ote_O mane_O oor_O ne_O ute_O fwambo_O ,_O bad_O migao_O mar_O thieth_O olero_O ni_O jii_O 169_O owe_O thuolo_O odok_O pacho_O bang_O chango_O ._O	luo
Magi ne oyangi gi jalup jatend migao mochungne yoore mag thieth e thurka laktar Mercy Mwangangi mane owacho ni kwan mar jii 796 no ne oyudi kuom kwan jii maromo alufu 6 gi 754 mane opim tok seche 24 mokalo	Magi_O ne_O oyangi_O gi_O jalup_O jatend_O migao_O mochungne_O yoore_O mag_O thieth_O e_O thurka_O laktar_O Mercy_B-PER Mwangangi_I-PER mane_O owacho_O ni_O kwan_O mar_O jii_O 796_O no_O ne_O oyudi_O kuom_O kwan_O jii_O maromo_O alufu_O 6_O gi_O 754_O mane_O opim_O tok_O seche_O 24_O mokalo_O	luo
Doho no ne ochak olor kata bang ogai mar Doho e pachoka David Maraga chiwo thuolo mondo mi oyaw kuondego bang yangore ni jii 11 matiyo e doho kanyo monywando okinde kod apisas mag doho ne jogamo midhusi noendo .	Doho_O no_O ne_O ochak_O olor_O kata_O bang_O ogai_O mar_O Doho_O e_O pachoka_O David_B-PER Maraga_I-PER chiwo_O thuolo_O mondo_O mi_O oyaw_O kuondego_O bang_O yangore_O ni_O jii_O 11_O matiyo_O e_O doho_O kanyo_O monywando_O okinde_O kod_O apisas_O mag_O doho_O ne_O jogamo_O midhusi_O noendo_O ._O	luo
Migosi Raila nowacho ni MCAS osebedo ka kuodo wii jii gi lweny ma gisiko godo e kinde ka kinde kar tiyone jopiny mane oyierogi	Migosi_B-PER Raila_I-PER nowacho_O ni_O MCAS_B-ORG osebedo_O ka_O kuodo_O wii_O jii_O gi_O lweny_O ma_O gisiko_O godo_O e_O kinde_O ka_O kinde_O kar_O tiyone_O jopiny_O mane_O oyierogi_O	luo
Kanowuoyo ewii wachno jalup jataa tije e duondno migosi Victor Bwire nowacho ni okang makama ochope bang weche yangore ni okak maduong medore e kind jofwambo to kod apisas mag obila	Kanowuoyo_O ewii_O wachno_O jalup_O jataa_O tije_O e_O duondno_O migosi_O Victor_B-PER Bwire_I-PER nowacho_O ni_O okang_O makama_O ochope_O bang_O weche_O yangore_O ni_O okak_O maduong_O medore_O e_O kind_O jofwambo_O to_O kod_O apisas_O mag_O obila_O	luo
Riwruog nurses e pachoka ochiwo notis mar 21 ne piny owacho ma malo gi piny owacho mag counties mondomi gikete tim winjruok mane giketoe e kokgi mar dok etich maka okotimore gibiro bago nganyo .	Riwruog_O nurses_O e_O pachoka_O ochiwo_O notis_O mar_O 21_O ne_O piny_O owacho_O ma_O malo_O gi_O piny_O owacho_O mag_O counties_O mondomi_O gikete_O tim_O winjruok_O mane_O giketoe_O e_O kokgi_O mar_O dok_O etich_O maka_O okotimore_O gibiro_O bago_O nganyo_O ._O	luo
Gi e kindeno jotuo mok 2 owito ngimagi gi tuo makochno .	Gi_O e_O kindeno_O jotuo_O mok_O 2_O owito_O ngimagi_O gi_O tuo_O makochno_O ._O	luo
Ringre ja sekondar pod imanyo	Ringre_O ja_O sekondar_O pod_O imanyo_O	luo
Ruoth ma gwenge go Joel Otieno yango ni ne ogweye e iye kuom hawi marach gi japuonjre machielo e kinde manegitugo opira bang penj ma tich abich kendo ring kode e kar thieth ma rodi kopany kama bange ne ochwale e kar thieth ma homabay county teaching and referal hospital ma Ongieloe orengo .	Ruoth_O ma_O gwenge_O go_O Joel_B-PER Otieno_I-PER yango_O ni_O ne_O ogweye_O e_O iye_O kuom_O hawi_O marach_O gi_O japuonjre_O machielo_O e_O kinde_O manegitugo_O opira_O bang_O penj_O ma_O tich_O abich_O kendo_O ring_O kode_O e_O kar_O thieth_O ma_O rodi_O kopany_O kama_O bange_O ne_O ochwale_O e_O kar_O thieth_O ma_O homabay_O county_O teaching_O and_O referal_O hospital_O ma_O Ongieloe_B-LOC orengo_O ._O	luo
ma en bang kamati ma ochungne chike to kod kum e duond bur mar odm ne golo paro mar dwaro riembo jaod bura ma malindi mikayi Aisha Jumwa kod jaod bura ma Msambweni Suleiman Dori kaluore kod weche mag rem luwo chike mag ODM kendo bedo gi tok teko	ma_O en_O bang_O kamati_O ma_O ochungne_O chike_O to_O kod_O kum_O e_O duond_O bur_O mar_O odm_O ne_O golo_O paro_O mar_O dwaro_O riembo_O jaod_O bura_O ma_O malindi_O mikayi_O Aisha_B-PER Jumwa_I-PER kod_O jaod_O bura_O ma_O Msambweni_B-PER Suleiman_I-PER Dori_I-PER kaluore_O kod_O weche_O mag_O rem_O luwo_O chike_O mag_O ODM_B-ORG kendo_O bedo_O gi_O tok_O teko_O	luo
Ngwele osebedo oko mar apisi chakre dwe mar 11 higa mokalo tok ka Elachi nondiko ne EACC ni noyiere e yoo maok ni kare .	Ngwele_O osebedo_O oko_O mar_O apisi_O chakre_O dwe_O mar_O 11_O higa_O mokalo_O tok_O ka_O Elachi_B-LOC nondiko_O ne_O EACC_B-ORG ni_O noyiere_O e_O yoo_O maok_O ni_O kare_O ._O	luo
Obila e subcounty ma Bondo okwedo weche moko mawuok kuom jotelo ni gitiyo kod thuolo mar apedha madhii nyime eapaya ekawo asoya kuom weg matatu kod jo bodaboda .	Obila_O e_O subcounty_O ma_O Bondo_O okwedo_O weche_O moko_O mawuok_O kuom_O jotelo_O ni_O gitiyo_O kod_O thuolo_O mar_O apedha_O madhii_O nyime_O eapaya_O ekawo_O asoya_O kuom_O weg_O matatu_O kod_O jo_O bodaboda_O ._O	luo
japuonjreno ma oyangi kaka Javan Onyango ne oyudo hinyruok e bund iy e kinde maneotugo kod jowetene opira e pap mar skundno .	japuonjreno_O ma_O oyangi_O kaka_O Javan_B-PER Onyango_O ne_O oyudo_O hinyruok_O e_O bund_O iy_O e_O kinde_O maneotugo_O kod_O jowetene_O opira_O e_O pap_O mar_O skundno_O ._O	luo
Maa en bang' ka MCAs 2 manyo omaki Homabay bende ne oseter e Kisumu kuno kendo ogeng' negi e tesend obila ma Kisumu ; mano MCA ma Kanyidoto Walter Were Muok ma en jatend kweth mathoth e od bura ma Homabay kod MCA ma Central Karachuonyo Julius Gaya .	Maa_O en_O bang'_O ka_O MCAs_B-ORG 2_O manyo_O omaki_O Homabay_B-PER bende_O ne_O oseter_O e_O Kisumu_B-ORG kuno_O kendo_O ogeng'_O negi_O e_O tesend_O obila_O ma_O Kisumu_B-ORG ;_O mano_O MCA_B-ORG ma_O Kanyidoto_O Walter_B-PER Were_I-PER Muok_O ma_O en_O jatend_O kweth_O mathoth_O e_O od_O bura_O ma_O Homabay_B-PER kod_O MCA_B-ORG ma_O Central_O Karachuonyo_O Julius_B-PER Gaya_I-PER ._O	luo
Kwan jii moyudi ni nikod tuo mar Coronavirus ei kawuononi gin jii 637	Kwan_O jii_O moyudi_O ni_O nikod_O tuo_O mar_O Coronavirus_O ei_O kawuononi_O gin_O jii_O 637_O	luo
Oguk wacho ni gisefwenyo ni jii sani thoro mana ng' iew yien e kuonde uso yedhe ka mamoko to limo nyamrerwa mae kor gwenge ka gimanyo thieth .	Oguk_O wacho_O ni_O gisefwenyo_O ni_O jii_O sani_O thoro_O mana_O ng'_O iew_O yien_O e_O kuonde_O uso_O yedhe_O ka_O mamoko_O to_O limo_O nyamrerwa_O mae_O kor_O gwenge_O ka_O gimanyo_O thieth_O ._O	luo
JII 960 OYUDO KORONA	JII_O 960_O OYUDO_B-ORG KORONA_I-ORG	luo
Jo Kakrao Ward Sub County ma Suna East e County ma Migori sani koro joseyo malit mokalo piny owacho mar County margino kod jotelo mane oyier gwenggi kuno kuom jwang' ogi kagiwacho gwengegigo osebedo ka odong chien e weche mag oongruok kuom higni modhuro	Jo_O Kakrao_O Ward_O Sub_O County_O ma_O Suna_O East_O e_O County_O ma_O Migori_O sani_O koro_O joseyo_O malit_O mokalo_O piny_O owacho_O mar_O County_O margino_O kod_O jotelo_O mane_O oyier_O gwenggi_O kuno_O kuom_O jwang'_O ogi_O kagiwacho_O gwengegigo_O osebedo_O ka_O odong_O chien_O e_O weche_O mag_O oongruok_O kuom_O higni_O modhuro_O	luo
Maeri en kaluwore g apisa moro mar thieth e countino James Oguk .	Maeri_O en_O kaluwore_O g_O apisa_O moro_O mar_O thieth_O e_O countino_O James_B-PER Oguk_I-PER ._O	luo
Kwan jii maromo 796 mane oyudi ni nigi Covid - 19 ei kawuononi	Kwan_O jii_O maromo_O 796_O mane_O oyudi_O ni_O nigi_O Covid_O -_O 19_O ei_O kawuononi_O	luo
Jatend duond bura mar ODM migosi Raila Amolo Odinga kawuono oseyo malit mokalo MCAS kuom tiyo marach gi omenda jopiny moketi mag weche dongruok	Jatend_O duond_O bura_O mar_O ODM_B-ORG migosi_O Raila_B-PER Amolo_I-PER Odinga_I-PER kawuono_O oseyo_O malit_O mokalo_O MCAS_B-ORG kuom_O tiyo_O marach_O gi_O omenda_O jopiny_O moketi_O mag_O weche_O dongruok_O	luo
ne opuoyo Ker Kenyatta kuom okenge ma piny owacho mare osekao mar kedo gi mibadhi ka okwaye mondo otime ma ok odewo ngato angata .	ne_O opuoyo_O Ker_B-PER Kenyatta_I-PER kuom_O okenge_O ma_O piny_O owacho_O mare_O osekao_O mar_O kedo_O gi_O mibadhi_O ka_O okwaye_O mondo_O otime_O ma_O ok_O odewo_O ngato_O angata_O ._O	luo
To kumachielo bende apisas mamoko 7 ma jotiyo e board mochungne insurance mar thieth ka NHIF bende nyo omaki	To_O kumachielo_O bende_O apisas_O mamoko_O 7_O ma_O jotiyo_O e_O board_O mochungne_O insurance_O mar_O thieth_O ka_O NHIF_B-ORG bende_O nyo_O omaki_O	luo
oketinegi to nyochane gineno ni gikau jii manyien emane gikawoe jagono ni to ne pok	oketinegi_O to_O nyochane_O gineno_O ni_O gikau_O jii_O manyien_O emane_O gikawoe_O jagono_O ni_O to_O ne_O pok_O	luo
Bad migao mar thieth olero ni mano koro kelo kwan jii moseyudo tuono chopo 17 , 603 .	Bad_O migao_O mar_O thieth_O olero_O ni_O mano_O koro_O kelo_O kwan_O jii_O moseyudo_O tuono_O chopo_O 17_O ,_O 603_O ._O	luo
Gavana ma Migori migosi Okoth Obado nyalo buonjo bang doho ma Kibra weye thuolo gi rambun mar silings gana 500 .	Gavana_O ma_O Migori_B-PER migosi_O Okoth_B-PER Obado_I-PER nyalo_O buonjo_O bang_O doho_O ma_O Kibra_B-ORG weye_O thuolo_O gi_O rambun_O mar_O silings_O gana_O 500_O ._O	luo
Kanowuoyo gi jopiny kachiel kachiel e tipo mar telebisen kowuok Afya House e boma ma Nairobika laktar Aman bende ne oyango ni nitie jii 10 mane tuono olal gi ngimagi ei kawuononi makoro kelo kwan jogo duto ma tuono osenego e thurka chopo jii 260	Kanowuoyo_O gi_O jopiny_O kachiel_O kachiel_O e_O tipo_O mar_O telebisen_O kowuok_O Afya_B-LOC House_O e_O boma_O ma_O Nairobika_O laktar_O Aman_B-PER bende_O ne_O oyango_O ni_O nitie_O jii_O 10_O mane_O tuono_O olal_O gi_O ngimagi_O ei_O kawuononi_O makoro_O kelo_O kwan_O jogo_O duto_O ma_O tuono_O osenego_O e_O thurka_O chopo_O jii_O 260_O	luo
Oppositon pod ochung kar tiende	Oppositon_O pod_O ochung_O kar_O tiende_O	luo
Doho oweyo thuolo gavana Obado gi rambun	Doho_O oweyo_O thuolo_O gavana_O Obado_B-PER gi_O rambun_O	luo
Nowacho ni winjruok margi mongére kaka Building Bridges Initiative sani luorore e tung Kenya mangima ka choko pach jopiny ewii kaka inyalotieko weche mag jotelo chamo pes jopinygo	Nowacho_O ni_O winjruok_O margi_O mongére_O kaka_O Building_B-ORG Bridges_I-ORG Initiative_I-ORG sani_O luorore_O e_O tung_O Kenya_B-LOC mangima_O ka_O choko_O pach_O jopiny_O ewii_O kaka_O inyalotieko_O weche_O mag_O jotelo_O chamo_O pes_O jopinygo_O	luo
Japuonjre ma jahigni 17 manetimo penj mar KCSE ongielo orengo	Japuonjre_O ma_O jahigni_O 17_O manetimo_O penj_O mar_O KCSE_O ongielo_O orengo_O	luo
Jago ma jahigni 41 ne omaki ka okwalo weyni mag keyo teko stima Ugenya	Jago_O ma_O jahigni_O 41_O ne_O omaki_O ka_O okwalo_O weyni_O mag_O keyo_O teko_O stima_O Ugenya_O	luo
ne owacho ni giseketo okenge to kod chenmro makare mar chiwo kum ne jogo mabiro ketho chike mag apaya	ne_O owacho_O ni_O giseketo_O okenge_O to_O kod_O chenmro_O makare_O mar_O chiwo_O kum_O ne_O jogo_O mabiro_O ketho_O chike_O mag_O apaya_O	luo
Jangad buche edoho ma Kibra Joyce Gandani ne okoni onge neno moromo mane ochiw gi jomin wach eloo piny manyalo miyo mmed gengne migosi Obado kuom thuolo mar jumbe 2 kaka ne gidwaro . .	Jangad_O buche_O edoho_O ma_O Kibra_B-PER Joyce_I-PER Gandani_I-PER ne_O okoni_O onge_O neno_O moromo_O mane_O ochiw_O gi_O jomin_O wach_O eloo_O piny_O manyalo_O miyo_O mmed_O gengne_O migosi_O Obado_B-PER kuom_O thuolo_O mar_O jumbe_O 2_O kaka_O ne_O gidwaro_O ._O ._O	luo
Mcas gin Evans Marieba , ma Gwasi North , Phelimon Onditi ( Kagan ) , Dan Were ( Kakelo Kokwanyo ) Paul Wamunga ( North Karachuonyo ward ) , kod Mca ma Wang' chieng ward Peter Kaula .	Mcas_O gin_O Evans_B-PER Marieba_I-PER ,_O ma_O Gwasi_B-PER North_I-PER ,_O Phelimon_B-PER Onditi_I-PER (_O Kagan_B-LOC )_O ,_O Dan_B-PER Were_I-PER (_O Kakelo_B-LOC Kokwanyo_I-LOC )_O Paul_B-PER Wamunga_I-PER (_O North_B-LOC Karachuonyo_I-LOC ward_O )_O ,_O kod_O Mca_O ma_O Wang'_O chieng_O ward_O Peter_B-PER Kaula_I-PER ._O	luo
Nowacho ni gima MCAS ongéyo en mana ngíyo rode moko ma ginyalochamo godo pes county kar tiyone jopiny	Nowacho_O ni_O gima_O MCAS_B-ORG ongéyo_O en_O mana_O ngíyo_O rode_O moko_O ma_O ginyalochamo_O godo_O pes_O county_O kar_O tiyone_O jopiny_O	luo
ONDIEK ONEGO JAMNI OCHIKO	ONDIEK_O ONEGO_O JAMNI_O OCHIKO_B-LOC	luo
Kanomedowuoyo ewii wachno mikai Oido nowacho ni magawa margino ok osebedo katiyo nikech pod ne gitemo mondo gichop chike mane oketigo mondo ekane giyepi ema koro nyochane gikawoe thuolo mar luongo apisas mochungne yoore thieth e County ma Homa Bay kuno chieng wuok tich mondo ne jobi opim jotijgi machon kod mane gikao manyien go mane jooro kwayo ni ne duaro tich kargi	Kanomedowuoyo_O ewii_O wachno_O mikai_O Oido_O nowacho_O ni_O magawa_O margino_O ok_O osebedo_O katiyo_O nikech_O pod_O ne_O gitemo_O mondo_O gichop_O chike_O mane_O oketigo_O mondo_O ekane_O giyepi_O ema_O koro_O nyochane_O gikawoe_O thuolo_O mar_O luongo_O apisas_O mochungne_O yoore_O thieth_O e_O County_B-LOC ma_O Homa_B-LOC Bay_I-LOC kuno_O chieng_O wuok_O tich_O mondo_O ne_O jobi_O opim_O jotijgi_O machon_O kod_O mane_O gikao_O manyien_O go_O mane_O jooro_O kwayo_O ni_O ne_O duaro_O tich_O kargi_O	luo
Duol matayo ute fwambo mapachoka mabende ongére kaka The Media Council of Kenya koro jochano bago lalruok makende e kind apisas mag obila kod ute fwambo mathurka kaka yoo mar neno ni winjruok maber obedo e kind kweth ariyogo mar neno ni ginyalotiyo kanyakla	Duol_O matayo_O ute_O fwambo_O mapachoka_O mabende_O ongére_O kaka_O The_B-ORG Media_I-ORG Council_I-ORG of_I-ORG Kenya_I-ORG koro_O jochano_O bago_O lalruok_O makende_O e_O kind_O apisas_O mag_O obila_O kod_O ute_O fwambo_O mathurka_O kaka_O yoo_O mar_O neno_O ni_O winjruok_O maber_O obedo_O e_O kind_O kweth_O ariyogo_O mar_O neno_O ni_O ginyalotiyo_O kanyakla_O	luo
Kanowuoyo ewii wachno jataa tije e magawa ma Blue Ridge Hotelno Hellen Oido nowacho ni gisebedo ka gikao jotich manyien ka gihikore godo ne yepo mar magawano bang lor mane olor godo magawa mapachoka nikech wach landruok mar tuo mar Covid - 19 kowacho ni kakoro nyochane jatend piny Kenya migosi Uhuru Kenyatta ne oyao magawa mathurka kendo mondo jotii e bwo chike mager manyochane	Kanowuoyo_O ewii_O wachno_O jataa_O tije_O e_O magawa_O ma_O Blue_B-ORG Ridge_I-ORG Hotelno_I-ORG Hellen_B-ORG Oido_I-ORG nowacho_O ni_O gisebedo_O ka_O gikao_O jotich_O manyien_O ka_O gihikore_O godo_O ne_O yepo_O mar_O magawano_O bang_O lor_O mane_O olor_O godo_O magawa_O mapachoka_O nikech_O wach_O landruok_O mar_O tuo_O mar_O Covid_O -_O 19_O kowacho_O ni_O kakoro_O nyochane_O jatend_O piny_O Kenya_B-LOC migosi_O Uhuru_B-PER Kenyatta_I-PER ne_O oyao_O magawa_O mathurka_O kendo_O mondo_O jotii_O e_O bwo_O chike_O mager_O manyochane_O	luo
Doho ma Mombasa kawuono ochako ayanga chenro mage mag winjo buche bang kanyocha olore kaluwore gi kwan mathoth mag jogo matiyo e doho kanyo manyocha oyangi ni neogamo midhusi mar Corona .	Doho_O ma_O Mombasa_B-LOC kawuono_O ochako_O ayanga_O chenro_O mage_O mag_O winjo_O buche_O bang_O kanyocha_O olore_O kaluwore_O gi_O kwan_O mathoth_O mag_O jogo_O matiyo_O e_O doho_O kanyo_O manyocha_O oyangi_O ni_O neogamo_O midhusi_O mar_O Corona_O ._O	luo
Jatelono mane loso e boma ma Siaya e romo mane obedo godo gi jofuamb weche ne owacho ni lalruok machalo kamano birochakore e higa manyien	Jatelono_O mane_O loso_O e_O boma_O ma_O Siaya_B-LOC e_O romo_O mane_O obedo_O godo_O gi_O jofuamb_O weche_O ne_O owacho_O ni_O lalruok_O machalo_O kamano_O birochakore_O e_O higa_O manyien_O	luo
Apisa mag obila mag wangapaya koro omi chik mar chwalo nyime kendo rido chike mag wangapaya e kinde nyasi mar christmas e counties 6 mag nyanza	Apisa_O mag_O obila_O mag_O wangapaya_O koro_O omi_O chik_O mar_O chwalo_O nyime_O kendo_O rido_O chike_O mag_O wangapaya_O e_O kinde_O nyasi_O mar_O christmas_O e_O counties_O 6_O mag_O nyanza_O	luo
Doho mar nyithindo owito oko bura ma yande ochwal miyo moro ma nyinge Mary Kwamboka ka ywak ni ogai mar bad migao mar doho justice David Maraga odagi kawo ting' mar nyathi ma owacho ni ne ginyuolo kode .	Doho_O mar_O nyithindo_O owito_O oko_O bura_O ma_O yande_O ochwal_O miyo_O moro_O ma_O nyinge_O Mary_B-PER Kwamboka_I-PER ka_O ywak_O ni_O ogai_O mar_O bad_O migao_O mar_O doho_O justice_O David_B-PER Maraga_I-PER odagi_O kawo_O ting'_O mar_O nyathi_O ma_O owacho_O ni_O ne_O ginyuolo_O kode_O ._O	luo
Achije 2 go majohigni 43 gi 48 nyoo okwalo dielno manyuok edala mama pamela atieno odindo ei chula ma Nyakagere mayudore enam lolwe kar saa 10 ma kogwen .	Achije_O 2_O go_O majohigni_O 43_O gi_O 48_O nyoo_O okwalo_O dielno_O manyuok_O edala_O mama_O pamela_O atieno_O odindo_O ei_O chula_O ma_O Nyakagere_O mayudore_O enam_O lolwe_O kar_O saa_O 10_O ma_O kogwen_O ._O	luo
ne okwedo weche moko maosebedo ka liekore ni oposition ma thurka orumo kaluowore kod mosruok maneobedo e kiind jatend kweth makwedo piny owacho Raila Amolo Odinga kor ker Uhuru Kenyatta .	ne_O okwedo_O weche_O moko_O maosebedo_O ka_O liekore_O ni_O oposition_O ma_O thurka_O orumo_O kaluowore_O kod_O mosruok_O maneobedo_O e_O kiind_O jatend_O kweth_O makwedo_O piny_O owacho_O Raila_B-PER Amolo_I-PER Odinga_I-PER kor_O ker_O Uhuru_B-PER Kenyatta_I-PER ._O	luo
Magawa ma Blue Ridge Hotel manie boma ma Mbita owacho ni jago manyo oyudi ni nigi Covid - 19 cha ok en jatijgi moyangi	Magawa_O ma_O Blue_B-ORG Ridge_I-ORG Hotel_I-ORG manie_O boma_O ma_O Mbita_O owacho_O ni_O jago_O manyo_O oyudi_O ni_O nigi_O Covid_O -_O 19_O cha_O ok_O en_O jatijgi_O moyangi_O	luo
Kwan mar jii madhi e ute mag thieth manyo thieth e County ma Migori odok piny mokalo nyaka ne midhusi mar corona muoji e thurka .	Kwan_O mar_O jii_O madhi_O e_O ute_O mag_O thieth_O manyo_O thieth_O e_O County_O ma_O Migori_O odok_O piny_O mokalo_O nyaka_O ne_O midhusi_O mar_O corona_O muoji_O e_O thurka_O ._O	luo
Aman bende nowacho ni County ma Nairobi emapod ne okao namba kuom bedo kod kwan maduong mag joma nigi midusi mar Covid - 19no mane gin jii 342	Aman_O bende_O nowacho_O ni_O County_B-LOC ma_O Nairobi_B-LOC emapod_O ne_O okao_O namba_O kuom_O bedo_O kod_O kwan_O maduong_O mag_O joma_O nigi_O midusi_O mar_O Covid_O -_O 19no_O mane_O gin_O jii_O 342_O	luo
ka giesani ringre osechwal e kar kano ringruok ma Homabay kairito timone bero .	ka_O giesani_O ringre_O osechwal_O e_O kar_O kano_O ringruok_O ma_O Homabay_B-PER kairito_O timone_O bero_O ._O	luo
BISOBE MAKPERE PUONJO WACH PIMO KAHERA	BISOBE_O MAKPERE_O PUONJO_O WACH_O PIMO_B-PER KAHERA_I-PER	luo
Bunde 5 ne oyudie eode ma Lavingtone ka 3 ne oyudi eode ma Migori ethuolo mane apisas mag okwach kich mawuok ka duol makedo gi mibadhi EACC ne joo timo nonro ewi mibadhii mar silings bilion 2 mawachore ne otii godo eyoo marach ecountyno .	Bunde_O 5_O ne_O oyudie_O eode_O ma_O Lavingtone_B-PER ka_O 3_O ne_O oyudi_O eode_O ma_O Migori_B-PER ethuolo_O mane_O apisas_O mag_O okwach_O kich_O mawuok_O ka_O duol_O makedo_O gi_O mibadhi_O EACC_B-ORG ne_O joo_O timo_O nonro_O ewi_O mibadhii_O mar_O silings_O bilion_O 2_O mawachore_O ne_O otii_O godo_O eyoo_O marach_O ecountyno_O ._O	luo
Bende ne oyangi ni nitie jii 499 mane ochango ei kawuononi ma owe odhi pacho kowacho ni kuom jogo , 403 ne gin jogo manyocha tuo to ne yudo thieth gie utegi mong' ere gi dho ngere kaka Home Based Care	Bende_O ne_O oyangi_O ni_O nitie_O jii_O 499_O mane_O ochango_O ei_O kawuononi_O ma_O owe_O odhi_O pacho_O kowacho_O ni_O kuom_O jogo_O ,_O 403_O ne_O gin_O jogo_O manyocha_O tuo_O to_O ne_O yudo_O thieth_O gie_O utegi_O mong'_O ere_O gi_O dho_O ngere_O kaka_O Home_O Based_O Care_O	luo
MCAno nyowacho ni form mag bursaryno birobedo eskunde duto mag piny owacho e Countyno mangima mar mondo mi ochiu thuolo mayot ne jopuonjre maonge gi nyalo e yudo formsgo ka obi oyau school e dwe mar 1 mar higa manyien mar oro kwayo mar yudo bursaryno	MCAno_O nyowacho_O ni_O form_O mag_O bursaryno_O birobedo_O eskunde_O duto_O mag_O piny_O owacho_O e_O Countyno_O mangima_O mar_O mondo_O mi_O ochiu_O thuolo_O mayot_O ne_O jopuonjre_O maonge_O gi_O nyalo_O e_O yudo_O formsgo_O ka_O obi_O oyau_O school_O e_O dwe_O mar_O 1_O mar_O higa_O manyien_O mar_O oro_O kwayo_O mar_O yudo_O bursaryno_O	luo
MCAs 9 ma Homabay ni e lwet obila	MCAs_B-ORG 9_O ma_O Homabay_O ni_O e_O lwet_O obila_O	luo
KWAN JOK MA MANYO THIETH ODOK PINY MIGORI	KWAN_O JOK_O MA_O MANYO_O THIETH_O ODOK_O PINY_O MIGORI_B-LOC	luo
Motelone mano Mcas go ne joo ochiwore ne obila mag okwach kich bang' yudo maling ling ni obila ne manyogi ewii wach monjo spika ma Homabay bange to ne ochwal gi enim doho .	Motelone_O mano_O Mcas_B-LOC go_O ne_O joo_O ochiwore_O ne_O obila_O mag_O okwach_O kich_O bang'_O yudo_O maling_O ling_O ni_O obila_O ne_O manyogi_O ewii_O wach_O monjo_O spika_O ma_O Homabay_B-PER bange_O to_O ne_O ochwal_O gi_O enim_O doho_O ._O	luo
Japuonjre ma jahigni 17 manetimo penj maduong mar kcse e skund sekondar ma DC mixed e gwenge ma Randung , Gem west location e constituency ma Rangwe ongielo orengo	Japuonjre_O ma_O jahigni_O 17_O manetimo_O penj_O maduong_O mar_O kcse_O e_O skund_O sekondar_O ma_O DC_O mixed_O e_O gwenge_O ma_O Randung_B-LOC ,_O Gem_O west_O location_O e_O constituency_O ma_O Rangwe_B-LOC ongielo_O orengo_O	luo
Apisas abiryogo gin Mudzo Nzili mawuok e county ma Kwale , Yussuf Ibrahiim , Simeon Kirgoty , Ruth Sudoi , Gilbert Kamau , Irene Rono kod Robert Mureithi	Apisas_O abiryogo_O gin_O Mudzo_B-PER Nzili_I-PER mawuok_O e_O county_O ma_O Kwale_O ,_O Yussuf_B-PER Ibrahiim_I-PER ,_O Simeon_B-PER Kirgoty_I-PER ,_O Ruth_B-PER Sudoi_I-PER ,_O Gilbert_B-PER Kamau_I-PER ,_O Irene_B-PER Rono_I-PER kod_O Robert_B-PER Mureithi_I-PER	luo
Edward Gichana osechamo muma kaka karan manyien mar od bura ma Nairobi .	Edward_B-PER Gichana_I-PER osechamo_O muma_O kaka_O karan_O manyien_O mar_O od_O bura_O ma_O Nairobi_B-LOC ._O	luo
Jo familia achiel mane jothogo gin ja higni 9 , ja higni 14 kod ja higni 20	Jo_O familia_O achiel_O mane_O jothogo_O gin_O ja_O higni_O 9_O ,_O ja_O higni_O 14_O kod_O ja_O higni_O 20_O	luo
Maraga oyudo fuong' ruok	Maraga_O oyudo_O fuong'_O ruok_O	luo
Kweth ma kamano notero kampen ma kamano e boma ma awasi kama nopuonj jo ohala ber mar dhi e pim e osiptal .	Kweth_O ma_O kamano_O notero_O kampen_O ma_O kamano_O e_O boma_O ma_O awasi_O kama_O nopuonj_O jo_O ohala_O ber_O mar_O dhi_O e_O pim_O e_O osiptal_O ._O	luo
Kanowuoyo Kisumu migosi Raila nowacho ni MCA mag counties ma Kisumu , Homa Bay , Nairobi kod Kakamega gin jogo ma jowuok oko mar nego devolution chutho mar neno ni devolution ok okelo ber moro amora e thurka	Kanowuoyo_O Kisumu_B-LOC migosi_O Raila_B-PER nowacho_O ni_O MCA_B-ORG mag_O counties_O ma_O Kisumu_B-LOC ,_O Homa_B-LOC Bay_I-LOC ,_O Nairobi_B-LOC kod_O Kakamega_B-LOC gin_O jogo_O ma_O jowuok_O oko_O mar_O nego_O devolution_O chutho_O mar_O neno_O ni_O devolution_O ok_O okelo_O ber_O moro_O amora_O e_O thurka_O	luo
Jalup county commisioner ma sub county ma Rangwe Elvis Kolum kaneyango wachni owachoni ne ochwale e kar thieth ma homabay county Referal Hospital ne thieth makende kama ne ongielo orengo .	Jalup_O county_O commisioner_O ma_O sub_O county_O ma_O Rangwe_B-LOC Elvis_I-PER Kolum_I-PER kaneyango_O wachni_O owachoni_O ne_O ochwale_O e_O kar_O thieth_O ma_O homabay_O county_O Referal_B-ORG Hospital_O ne_O thieth_O makende_O kama_O ne_O ongielo_O orengo_O ._O	luo
Pes bursary ma County ma Homa Bay koro oyudo mijing'o	Pes_O bursary_O ma_O County_B-ORG ma_O Homa_B-LOC Bay_I-LOC koro_O oyudo_O mijing'o_O	luo
Mcas mawuok ecounty assembly ma Homabay mane ochwal enyim doho maKisumu kendo odonjnegi kod ketho mar monjo spika mar county assemblyno mikayi Elizabeth Ayoo joo dhii bedo erumend ma Kodiaga kuom jumbe ariyo ka nonro dhii nyime .	Mcas_O mawuok_O ecounty_O assembly_O ma_O Homabay_B-PER mane_O ochwal_O enyim_O doho_O maKisumu_O kendo_O odonjnegi_O kod_O ketho_O mar_O monjo_O spika_O mar_O county_O assemblyno_O mikayi_O Elizabeth_B-PER Ayoo_I-PER joo_O dhii_O bedo_O erumend_O ma_O Kodiaga_O kuom_O jumbe_O ariyo_O ka_O nonro_O dhii_O nyime_O ._O	luo
kanyo - mane odhi opim ne tuo mar Coronavirusno	kanyo_O -_O mane_O odhi_O opim_O ne_O tuo_O mar_O Coronavirusno_O	luo
Briton Mike Odhiambo nyo okier molwar e pii odhiambo ma nyoro kanyo otemo gamo besen moro manyo oriko dhii gi pii .	Briton_O Mike_B-PER Odhiambo_I-PER nyo_O okier_O molwar_O e_O pii_O odhiambo_O ma_O nyoro_O kanyo_O otemo_O gamo_O besen_O moro_O manyo_O oriko_O dhii_O gi_O pii_O ._O	luo
Odiechieng manyoro moko kuom jo boda boda gi jotelo mawuok siaya kotelnegi kod mca ma ogwel ecounty assembly ma Siaya Tabu Osewe ne oseyo apisas mag obila kane gikoni gisebedo ka gisando weg matatu ka gikawo asoya kuomgi .	Odiechieng_O manyoro_O moko_O kuom_O jo_O boda_O boda_O gi_O jotelo_O mawuok_O siaya_O kotelnegi_O kod_O mca_O ma_O ogwel_O ecounty_O assembly_O ma_O Siaya_B-PER Tabu_I-PER Osewe_I-PER ne_O oseyo_O apisas_O mag_O obila_O kane_O gikoni_O gisebedo_O ka_O gisando_O weg_O matatu_O ka_O gikawo_O asoya_O kuomgi_O ._O	luo
Magi ne oyangi kod jalup jatend migao mochungne yoore mag thieth e pachoka laktar Rashid Aman	Magi_O ne_O oyangi_O kod_O jalup_O jatend_O migao_O mochungne_O yoore_O mag_O thieth_O e_O pachoka_O laktar_O Rashid_B-PER Aman_I-PER	luo
Nyasi ma kamano notelie kkod spika Beatrivce Elachi mana odiechieng achiel tok kanyo opuodh nyinge gi od burano e romo manyokelo fwere , ka koro nenore ni lweny manyien nyalo biro muoch e assembly ma Nairobi .	Nyasi_O ma_O kamano_O notelie_O kkod_O spika_O Beatrivce_B-PER Elachi_I-PER mana_O odiechieng_O achiel_O tok_O kanyo_O opuodh_O nyinge_O gi_O od_O burano_O e_O romo_O manyokelo_O fwere_O ,_O ka_O koro_O nenore_O ni_O lweny_O manyien_O nyalo_O biro_O muoch_O e_O assembly_O ma_O Nairobi_B-LOC ._O	luo
jotelogi ne ohum kod kwan jopiny china ma osemedore e pachoka ka okwayo piny wacho mondo ongi matut wachni kotenore kod uchumi ma pachoka	jotelogi_O ne_O ohum_O kod_O kwan_O jopiny_O china_O ma_O osemedore_O e_O pachoka_O ka_O okwayo_O piny_O wacho_O mondo_O ongi_O matut_O wachni_O kotenore_O kod_O uchumi_O ma_O pachoka_O	luo
MCAs mamoko 7 mag county ma Homabay jochopo gin giwegi e nyim obila mag okwach kich e boma ma Kisumu okinyi ma kawuono ewii wach monj ma nyocha omonjgo spika ma homabay mikayi Elizabeth Ayoo .	MCAs_B-ORG mamoko_O 7_O mag_O county_O ma_O Homabay_B-LOC jochopo_O gin_O giwegi_O e_O nyim_O obila_O mag_O okwach_O kich_O e_O boma_O ma_O Kisumu_O okinyi_O ma_O kawuono_O ewii_O wach_O monj_O ma_O nyocha_O omonjgo_O spika_O ma_O homabay_O mikayi_O Elizabeth_B-PER Ayoo_I-PER ._O	luo
Senator machon mar county ma Kakamega migosi Boni Khalwale koro kwayo jood bura mag ODM mondo mii oriemb ogai mar nasa raila amolo odinga e duond burano .	Senator_O machon_O mar_O county_O ma_O Kakamega_B-LOC migosi_O Boni_B-PER Khalwale_I-PER koro_O kwayo_O jood_O bura_O mag_O ODM_B-ORG mondo_O mii_O oriemb_O ogai_O mar_O nasa_O raila_O amolo_O odinga_O e_O duond_O burano_O ._O	luo
Kwan jogo man kod midusi mar Coronavirus e bwo piny mangima koro en million 16 gi alufu 48 gi 101 ka kwan jogo ma tuono osenego e bwo piny mangima gin jii alufu 644 gi 679	Kwan_O jogo_O man_O kod_O midusi_O mar_O Coronavirus_O e_O bwo_O piny_O mangima_O koro_O en_O million_O 16_O gi_O alufu_O 48_O gi_O 101_O ka_O kwan_O jogo_O ma_O tuono_O osenego_O e_O bwo_O piny_O mangima_O gin_O jii_O alufu_O 644_O gi_O 679_O	luo
kowacho ni piny ma dhano ngimae e piny manyalobedo kod dongruok mowinjore	kowacho_O ni_O piny_O ma_O dhano_O ngimae_O e_O piny_O manyalobedo_O kod_O dongruok_O mowinjore_O	luo
Media Council of Kenya chano bago lalruok e kind obila gi jofuamb weche	Media_B-ORG Council_I-ORG of_I-ORG Kenya_I-ORG chano_O bago_O lalruok_O e_O kind_O obila_O gi_O jofuamb_O weche_O	luo
Kane omedo loso ewii wachno mikayi Harriet ne okoni joo go mapod okluw chikego mag apaya ibiro maki machwal enyim doho kendo donjnegi kod keth mar rem luwo chike mag apaya .	Kane_B-PER omedo_O loso_O ewii_O wachno_O mikayi_O Harriet_B-PER ne_O okoni_O joo_O go_O mapod_O okluw_O chikego_O mag_O apaya_O ibiro_O maki_O machwal_O enyim_O doho_O kendo_O donjnegi_O kod_O keth_O mar_O rem_O luwo_O chike_O mag_O apaya_O ._O	luo
Odinga seyo MCAs kuom chamo pes jopiny	Odinga_O seyo_O MCAs_B-ORG kuom_O chamo_O pes_O jopiny_O	luo
Obila ne ogengone jago moro ma jahigni 41 e tesend obila ma Ukwala bang kane omake ka okwalo weyni mag keyo teko stima egweng ma Ligega Ugenya sub - county	Obila_O ne_O ogengone_O jago_O moro_O ma_O jahigni_O 41_O e_O tesend_O obila_O ma_O Ukwala_B-LOC bang_O kane_O omake_O ka_O okwalo_O weyni_O mag_O keyo_O teko_O stima_O egweng_O ma_O Ligega_O Ugenya_B-LOC sub_O -_O county_O	luo
Obila ma Bondo okwedo weche moko ni gikao asoya eseche ma gitimo apedha eapaya	Obila_O ma_O Bondo_O okwedo_O weche_O moko_O ni_O gikao_O asoya_O eseche_O ma_O gitimo_O apedha_O eapaya_O	luo
Jogwenggo joowacho ni gisetemo golo yuak margi ewii gik ma giduaro ni ng' iigo ne MCA margi migosi George Owiti to MCAno osebedo ka okao mamalo gi ma piny omuno maok oduar katamana wuoyo ewii wachno	Jogwenggo_O joowacho_O ni_O gisetemo_O golo_O yuak_O margi_O ewii_O gik_O ma_O giduaro_O ni_O ng'_O iigo_O ne_O MCA_B-ORG margi_O migosi_O George_B-PER Owiti_I-PER to_O MCAno_B-ORG osebedo_O ka_O okao_O mamalo_O gi_O ma_O piny_O omuno_O maok_O oduar_O katamana_O wuoyo_O ewii_O wachno_O	luo
Jaloero mane oyudo ilao gi apisa marito bunge nokier molwar koridore e gode ma gwassi kanyo ema kaeto nowito ngimane .	Jaloero_O mane_O oyudo_O ilao_O gi_O apisa_O marito_O bunge_O nokier_O molwar_O koridore_O e_O gode_O ma_O gwassi_O kanyo_O ema_O kaeto_O nowito_O ngimane_O ._O	luo
Ng'anyo mar nurses mane ochan timo wuok tich koro ochwal nyime	Ng'anyo_O mar_O nurses_O mane_O ochan_O timo_O wuok_O tich_O koro_O ochwal_O nyime_O	luo
Kwan jii ma oyudi kod tuo mar Coronavirus ei kawuononi gin 637 makoro kelo kwan jogo duto man kod tuo magalagalano e pachoka chopo jii alufu 14 gi 805	Kwan_O jii_O ma_O oyudi_O kod_O tuo_O mar_O Coronavirus_O ei_O kawuononi_O gin_O 637_O makoro_O kelo_O kwan_O jogo_O duto_O man_O kod_O tuo_O magalagalano_O e_O pachoka_O chopo_O jii_O alufu_O 14_O gi_O 805_O	luo
Kwan jii mane oyudi ni nikod tuo mar Coronavirus ei kawuononi gin jii 796 makoro kelo kwan jogo duto man kod midusi makochno e pachoka ei kawuononi chopo jii alufu 15 gi 601	Kwan_O jii_O mane_O oyudi_O ni_O nikod_O tuo_O mar_O Coronavirus_B-ORG ei_O kawuononi_O gin_O jii_O 796_O makoro_O kelo_O kwan_O jogo_O duto_O man_O kod_O midusi_O makochno_O e_O pachoka_O ei_O kawuononi_O chopo_O jii_O alufu_O 15_O gi_O 601_O	luo
Jii 3 moko ma oting'o nyithindo 2 mawuok e familia achiel ne jotho kanyo kanyo ka mamoko 3 to rem nego bang polo gogi e gwenge mag Achudinet ei Teso North	Jii_O 3_O moko_O ma_O oting'o_O nyithindo_O 2_O mawuok_O e_O familia_O achiel_O ne_O jotho_O kanyo_O kanyo_O ka_O mamoko_O 3_O to_O rem_O nego_O bang_O polo_O gogi_O e_O gwenge_O mag_O Achudinet_B-LOC ei_O Teso_B-LOC North_I-LOC	luo
Motelo odiechieng ma kawuono , yuaruok nomuoch bang' spika Elachi nodagi yango Jacob Ngwele kaka karan mar od Burano .	Motelo_O odiechieng_O ma_O kawuono_O ,_O yuaruok_O nomuoch_O bang'_O spika_O Elachi_B-ORG nodagi_O yango_O Jacob_B-PER Ngwele_I-PER kaka_O karan_O mar_O od_O Burano_B-LOC ._O	luo
Riuruogno ne okao okang machalo kamano mar mondo mi gimi duol mochungne osach jotij piny owacho - Salaries and Remuneration Commission thuolo maber mar chopo dwach winjruok manegibedo godo kodgi mar medogi osara	Riuruogno_O ne_O okao_O okang_O machalo_O kamano_O mar_O mondo_O mi_O gimi_O duol_O mochungne_O osach_O jotij_O piny_O owacho_O -_O Salaries_B-ORG and_I-ORG Remuneration_I-ORG Commission_I-ORG thuolo_O maber_O mar_O chopo_O dwach_O winjruok_O manegibedo_O godo_O kodgi_O mar_O medogi_O osara_O	luo
DOHO MA MOMBASA OCHAKO WINJO BUCHE AYANGA	DOHO_B-LOC MA_O MOMBASA_O OCHAKO_B-LOC WINJO_B-LOC BUCHE_O AYANGA_B-LOC	luo
migosi kingi ne owaco ni weg nyamburko matingo jowuoth e kinde nyasi mar christamas nyaka bed kod obok madwarore mar chwalo jowuoth e pachoka	migosi_O kingi_O ne_O owaco_O ni_O weg_O nyamburko_O matingo_O jowuoth_O e_O kinde_O nyasi_O mar_O christamas_O nyaka_O bed_O kod_O obok_O madwarore_O mar_O chwalo_O jowuoth_O e_O pachoka_O	luo
Bunge mar County ma Homa Bay koro otimo lokruok ne chike matayo weche mag chiwo bursary mag somo mongere kaka Education Bursary Fund Ammendment bill 2018 mabiro konyo neno ni jogo ma odak gi ng'ol bende onyuandi e komiti mochungne bursary kod konyo neno ni bursaryno ipogo e yoo mowinjore maonge mibadhi moro amora	Bunge_O mar_O County_B-LOC ma_O Homa_B-LOC Bay_I-LOC koro_O otimo_O lokruok_O ne_O chike_O matayo_O weche_O mag_O chiwo_O bursary_O mag_O somo_O mongere_O kaka_O Education_B-ORG Bursary_I-ORG Fund_I-ORG Ammendment_O bill_O 2018_B-DATE mabiro_O konyo_O neno_O ni_O jogo_O ma_O odak_O gi_O ng'ol_O bende_O onyuandi_O e_O komiti_O mochungne_O bursary_O kod_O konyo_O neno_O ni_O bursaryno_O ipogo_O e_O yoo_O mowinjore_O maonge_O mibadhi_O moro_O amora_O	luo
Ogai mar nasa Raila Amolo Odinga koro okwayo jodak e county ma kisumu mondo mii oikore mar rwako ker Kenyataa e kinde ma obiro wendo bomano machiegni e dwe marapar gariyo limbeno mokuongo mar ker kenyataa chakre yiero ma higa mokalo to kod tok mosruok e kindgi dwe mar adek higani	Ogai_O mar_O nasa_O Raila_B-PER Amolo_I-PER Odinga_I-PER koro_O okwayo_O jodak_O e_O county_O ma_O kisumu_O mondo_O mii_O oikore_O mar_O rwako_O ker_O Kenyataa_O e_O kinde_O ma_O obiro_O wendo_O bomano_O machiegni_O e_O dwe_O marapar_O gariyo_O limbeno_O mokuongo_O mar_O ker_O kenyataa_O chakre_O yiero_O ma_O higa_O mokalo_O to_O kod_O tok_O mosruok_O e_O kindgi_O dwe_O mar_O adek_O higani_O	luo
Nyo oyango ni wards 40 mag County ma Homa Baygo oketnegi omenda maromo silings million 2 . 5 mar hik manyonge mar 2018 / 2019 kowuok e silings million 1 . 5 mane entieree e budget mokalo mar neno ni nyithindo duto maonge gi nyalo joyudo pes bursaryno	Nyo_O oyango_O ni_O wards_O 40_O mag_O County_O ma_O Homa_B-LOC Baygo_I-LOC oketnegi_O omenda_O maromo_O silings_O million_O 2_O ._O 5_O mar_O hik_O manyonge_O mar_O 2018_B-DATE /_I-DATE 2019_O kowuok_O e_O silings_O million_O 1_O ._O 5_O mane_O entieree_O e_O budget_O mokalo_O mar_O neno_O ni_O nyithindo_O duto_O maonge_O gi_O nyalo_O joyudo_O pes_O bursaryno_O	luo
Apisas abiryogo nyo omaki kaluwore kod wach kuo mar omenda e boardno	Apisas_O abiryogo_O nyo_O omaki_O kaluwore_O kod_O wach_O kuo_O mar_O omenda_O e_O boardno_O	luo
Jayal bura Gerald Gitonga okoo ni burano ne onge kod mise motegno kaka ne ochwale e doho .	Jayal_O bura_O Gerald_B-PER Gitonga_I-PER okoo_O ni_O burano_O ne_O onge_O kod_O mise_O motegno_O kaka_O ne_O ochwale_O e_O doho_O ._O	luo
Miyo moro achiel mane gin godo to kata kamano nomaki .	Miyo_O moro_O achiel_O mane_O gin_O godo_O to_O kata_O kamano_O nomaki_O ._O	luo
Kanomedowuoyo ewii wachno migosi Otieno nowacho ni giduaro ni wach ndara maricho makono ng' ii kaachiel gi ng' iyo wach taya mag chiche makono kod wach pur ndawa masani koro odok chieng kuno bende ng' ii	Kanomedowuoyo_O ewii_O wachno_O migosi_O Otieno_B-PER nowacho_O ni_O giduaro_O ni_O wach_O ndara_O maricho_O makono_O ng'_O ii_O kaachiel_O gi_O ng'_O iyo_O wach_O taya_O mag_O chiche_O makono_O kod_O wach_O pur_O ndawa_O masani_O koro_O odok_O chieng_O kuno_O bende_O ng'_O ii_O	luo